R 1650 1050
NO ./statics/textures/christmas_blue_256.xpm
SO ./statics/textures/christmas_red_256.xpm
WE ./statics/textures/christmas_brown_256.xpm
EA ./statics/textures/christmas_green_256.xpm

F 200,200,200
C 250,250,250

        1111111111111111111111111
        1000000000000000000000001
        1011000000000000000000001
        1001000000000000000000001
111111111011000000000000000000001
100000000011000001000111111111111
11110111111111011100000000001
11110111111111011101010010001
11000000110101011100000010001
10000000000000001100000010001
10000000000000001101010010001
1100000111010101111101111010111
11110111 1110101 1011110100N1
11111111 1111111 111111111111
