NO ./texture/redbrick.xpm
SO ./texture/tile2.xpm
WE ./texture/eagle.xpm
EA ./texture/tile4.xpm

F 200,200,200
C 250,250,250

1111
1N01
0101
1111
